##############################Dd#######
#######                               #
#                                     #
#             #################       #
#                       ######        #
#########                    #        #
#           ##               #       ##
#           ###              #       ##
#            ######          ##########
##             #                     ##
##             #                     ##
##       ##          ######          ##
##        #          ##               #
##                                    #
##           #        ###             #
#####        #         #######        #
##      ######               #       ##
#         #####                     ###
#                    ####             #
#                   ##                #
#       ##############          ###   #
#######################################

