##############################DD#######
#######                               #
#                                     #
#             ################        #
#                       ######        #
#                            #        #
#           ##               #       ##
#           ###              #       ##
#            ######          #       ##
##                                   ##
##                                   ##
##       ##                          ##
##        #                           #
##                                    #
##                    ###             #
##                     #######        #
##      ######            ##          #
#                                     #
#                                     #
#                                     #
#       ##############          ###   #
#######################################

